[
    [1, 1, 1, 1, 1, 1, 1, 1, 1, 1, 1, 1, 1, 1, 1, 1, 1, 1, 1, 1, 1, 1, 1, 1, 1, 1, 1, 1, 1, 1],
    [1, 5, 0, 0, 0, 0, 0, 0, 0, 0, 1, 0, 0, 0, 4, 0, 0, 0, 1, 0, 0, 0, 0, 0, 0, 0, 0, 0, 3, 1],
    [1, 0, 1, 1, 6, 1, 1, 0, 0, 0, 6, 0,11, 0, 0, 0,11, 0, 6, 0, 0,0,1, 1, 6, 1, 1, 0, 0, 1],
    [1, 0, 1,12, 0, 0, 1, 0, 4, 0, 1, 0, 0, 0, 0, 0, 0, 0, 1, 0, 4, 0,1, 0, 0,12, 1, 0, 0, 1],
    [1, 0, 6, 0, 4, 0, 6, 0, 0, 0, 1, 1, 1, 6, 6, 1, 1, 1, 1, 0, 0, 0, 6, 0, 4, 0, 6, 0, 4, 1],
    [1, 0, 1, 0, 0, 0, 1, 0, 0, 0, 0, 0, 0, 0, 4, 0, 0, 0, 0, 0, 0, 0, 1, 0, 0, 0, 1, 0, 0, 1],
    [1, 0, 1, 1, 6, 1, 1, 0, 1, 1, 0, 1, 1, 1, 1, 1, 1, 1, 0, 1, 1, 0, 1, 1, 6, 1, 1, 0, 4, 1],
    [1, 0, 0, 0, 4, 0, 0, 0, 1, 4, 0, 1, 0, 0, 0, 0, 0, 1, 0, 4, 1, 0, 0, 0, 4, 0, 0, 0, 0, 1],
    [1, 1, 1, 1, 1, 1, 1, 0, 1, 0, 0, 6, 0,11, 0,11, 0, 6, 0, 0, 1, 0, 1, 1, 1, 1, 1, 1, 1, 1],
    [1, 4, 0, 0, 0, 0, 1, 0, 1,12,12, 6, 0, 0, 4, 0, 0, 1, 0, 0, 1, 0, 1, 0, 0, 0, 0, 0, 0, 1],
    [1, 0, 4, 0, 4, 0, 6, 0, 1, 4,12, 1, 0, 0, 0, 0, 0, 1, 0, 4, 1, 0, 6, 0, 4, 0, 4, 0, 0, 1],
    [1, 0, 0, 0, 0, 0, 6, 0, 6, 0,12, 1, 1, 1, 6, 1, 1, 1, 4, 0, 1, 0, 1, 0, 0, 0, 0, 0, 4, 1],
    [1, 1, 1, 6, 1, 1, 1, 0, 6, 0,12, 0, 0, 0, 0, 0, 0, 0, 0, 0, 6, 0, 1, 1, 6, 6, 1, 1, 1, 1],
    [1, 0, 0, 0, 0, 0, 0, 0, 1, 0,11, 1, 1, 1, 1, 1, 1, 1, 0, 0, 1, 0, 0, 0, 0, 0, 0, 0, 0, 1],
    [1, 4, 0, 0, 4, 0, 0, 0, 1, 4, 0, 1, 7, 0,12,12, 9, 1, 0, 4, 1, 0, 0, 0, 4, 0, 0, 0, 4, 1],
    [1, 0, 1, 1, 1, 1, 1, 0, 1, 0, 0, 6, 0, 0, 4, 0, 0, 6, 4, 0, 1, 0, 1, 1, 1, 1, 1,11,12, 1],
    [1, 0, 1, 0, 0, 0, 1, 0, 1, 0, 0, 6, 0,11, 0,12, 0, 6, 0, 0, 1, 0, 1, 0, 0, 0, 1, 0, 0, 1],
    [1, 4, 6, 0, 4, 0, 6, 0, 1, 4, 0, 1, 0, 4,11, 0, 0, 1, 0, 4, 1, 0, 6, 0, 4, 0, 6, 0, 4, 1],
    [1, 0, 1, 0, 0, 0, 1, 0, 6, 0, 0, 1, 1, 1, 6, 1, 1, 1, 0, 0, 1, 0, 6, 0, 0, 0, 1, 0, 0, 1],
    [1, 0, 1, 1, 6, 1, 1, 4, 6, 0, 0, 0, 0, 0, 0, 0, 0, 4, 0, 0, 6, 0, 1, 1, 6, 1, 1, 0, 0, 1],
    [1, 4, 0, 0, 4, 0, 0, 0, 1, 0, 0, 1, 1, 1, 1, 1, 1, 1, 0, 0, 1, 0, 0, 0, 4, 0, 0, 0, 4, 1],
    [1, 0, 0, 0, 0, 0, 0, 0, 1, 4, 0, 1, 8, 0, 0, 0,10, 1, 0, 4, 1, 0, 0, 0, 0, 0, 0, 0, 0, 1],
    [1, 1, 1, 6, 1, 1, 1, 4, 1, 0, 0, 1, 0,12, 4, 0, 0, 1, 0, 0, 1, 0, 1, 1, 6, 6, 1, 1, 1, 1],
    [1, 0, 0, 0, 0, 0, 1, 0, 1, 0, 0, 6, 0, 0, 0,12, 0, 6, 0, 0, 1, 0, 1, 0, 4, 0, 0, 0, 0, 1],
    [1, 4, 4, 0, 4, 0, 6, 0, 1, 4, 0, 1, 0, 0, 0, 0, 0, 1, 0, 4, 1, 0, 6, 0, 4, 0, 4, 0, 4, 1],
    [1, 0, 0, 0, 0, 0, 1, 0, 1, 0, 0, 1,12, 0, 4, 0, 0, 1, 0, 0, 1, 0, 1, 0, 0, 0, 0, 0, 0, 1],
    [1, 1, 1, 1, 1, 1, 1, 4, 1, 0, 0, 6, 0,11, 0,11, 0, 6, 0, 0, 1, 0, 1, 1, 1, 1, 1, 1, 1, 1],
    [1, 0, 0, 0, 4, 0, 0, 0, 1, 4, 0, 1, 0, 0, 0, 0, 0, 1, 0, 4, 1, 0, 0, 0, 4, 0, 0, 0, 4, 1],
    [1, 0, 1, 1, 6, 6, 1, 0, 1, 1, 0, 1, 1, 1, 1, 1, 1, 1, 0, 1, 1, 0, 1, 1, 6, 1, 1, 0, 0, 1],
    [1, 0, 1, 9, 0, 0, 1, 4, 0, 0, 0, 0, 0, 0, 4, 0, 0, 0, 0, 0, 0, 0, 1,10, 0, 0, 1, 0, 4, 1],
    [1, 4, 6, 0, 4, 0, 6, 0, 0, 0, 1, 1, 1, 6, 1, 6, 1, 1, 1, 0, 0, 0, 6, 0, 4,11, 6, 0, 0, 1],
    [1, 0, 1,12, 0, 0, 1, 4, 4, 0, 1, 0, 0, 0, 0, 0, 0, 0, 1, 0, 4, 0, 1, 0, 0,12, 1, 0, 0, 1],
    [1, 4, 1, 1, 6, 6, 1, 0, 0, 0, 6, 0,11, 0, 0, 0,11, 0, 6, 0, 0, 0, 1, 1, 6, 1, 1, 0, 0, 1],
    [1, 2, 0, 0, 0, 0, 0, 0, 0, 0, 1, 0, 0, 0, 4, 0, 0, 0, 1, 0, 0, 4,11,11, 0, 0, 0, 0, 3, 1],
    [1, 0, 0,12,12,11, 0, 0, 0, 0, 0, 0, 0, 0, 0, 0, 0,12,12, 0, 0, 0,11,11, 0, 4, 0, 2, 0, 1],
    [1, 1, 1, 1, 1, 1, 1, 1, 1, 1, 1, 1, 1, 1, 1, 1, 1, 1, 1, 1, 1, 1, 1, 1, 1, 1, 1, 1, 1, 1]
]