[
    [1, 1, 1, 1, 1, 1, 1, 1, 1, 1, 1, 1, 1, 1, 1, 1, 1, 1, 1, 1, 1, 1, 1, 1, 1, 1, 1, 1, 1, 1],
    [1, 5, 0, 0, 0, 0, 0, 0, 0, 0, 1, 0, 0, 0, 4, 0, 0, 0, 1, 0, 0, 0, 0, 0, 0, 0, 0, 0, 3, 1],
    [1, 0, 1, 1, 6, 1, 1, 0, 0, 0, 6, 0, 11, 0, 0, 0, 11, 0, 6, 0, 0, 0, 1, 1, 6, 1, 1, 0, 0, 1],
    [1, 0, 1, 12, 0, 0, 1, 0, 4, 0, 1, 0, 0, 0, 0, 0, 0, 0, 1, 0, 4, 0, 1, 0, 0, 12, 1, 0, 0, 1],
    [1, 0, 6, 0, 4, 0, 6, 0, 0, 0, 1, 1, 1, 6, 1, 6, 1, 1, 1, 0, 0, 0, 6, 0, 4, 0, 6, 0, 4, 1],
    [1, 0, 1, 0, 0, 0, 1, 0, 0, 0, 0, 0, 0, 0, 4, 0, 0, 0, 0, 0, 0, 0, 1, 0, 0, 0, 1, 0, 0, 1],
    [1, 0, 1, 1, 6, 1, 1, 0, 1, 1, 0, 1, 1, 1, 1, 1, 1, 1, 0, 1, 1, 0, 1, 1, 6, 1, 1, 0, 4, 1],
    [1, 0, 0, 0, 4, 0, 0, 0, 1, 4, 0, 1, 0, 0, 0, 0, 0, 1, 0, 4, 1, 0, 0, 0, 4, 0, 0, 0, 0, 1],
    [1, 1, 1, 1, 1, 1, 1, 0, 1, 0, 0, 6, 0, 11, 0, 11, 0, 6, 0, 0, 1, 0, 1, 1, 1, 1, 1, 1, 1, 1],
    [1, 4, 0, 0, 0, 0, 1, 0, 1, 0, 0, 1, 0, 0, 4, 0, 0, 1, 0, 0, 1, 0, 1, 0, 0, 0, 0, 0, 0, 1],
    [1, 0, 4, 0, 4, 0, 6, 0, 1, 4, 0, 1, 0, 0, 0, 0, 0, 1, 0, 4, 1, 0, 6, 0, 4, 0, 4, 0, 0, 1],
    [1, 0, 0, 0, 0, 0, 1, 0, 1, 0, 0, 1, 1, 1, 6, 1, 1, 1, 4, 0, 1, 0, 1, 0, 0, 0, 0, 0, 4, 1],
    [1, 1, 1, 6, 1, 1, 1, 0, 6, 0, 0, 0, 0, 0, 0, 0, 0, 0, 0, 0, 6, 0, 1, 1, 1, 6, 1, 1, 1, 1],
    [1, 0, 0, 0, 0, 0, 0, 0, 1, 0, 0, 1, 1, 1, 1, 1, 1, 1, 0, 0, 1, 0, 0, 0, 0, 0, 0, 0, 0, 1],
    [1, 4, 0, 0, 4, 0, 0, 0, 1, 4, 0, 1, 7, 0, 0, 0, 9, 1, 0, 4, 1, 0, 0, 0, 4, 0, 0, 0, 4, 1],
    [1, 0, 1, 1, 1, 1, 1, 0, 1, 0, 0, 1, 0, 0, 4, 0, 0, 1, 4, 0, 1, 0, 1, 1, 1, 1, 1, 0, 0, 1],
    [1, 0, 1, 0, 0, 0, 1, 0, 1, 0, 0, 6, 0, 0, 0, 0, 0, 6, 0, 0, 1, 0, 1, 0, 0, 0, 1, 0, 0, 1],
    [1, 4, 6, 0, 4, 0, 6, 0, 1, 4, 0, 1, 0, 4, 0, 0, 0, 1, 0, 4, 1, 0, 6, 0, 4, 0, 6, 0, 4, 1],
    [1, 0, 1, 0, 0, 0, 1, 0, 1, 0, 0, 1, 1, 1, 6, 1, 1, 1, 0, 0, 1, 0, 1, 0, 0, 0, 1, 0, 0, 1],
    [1, 0, 1, 1, 6, 1, 1, 4, 6, 0, 0, 0, 0, 0, 0, 0, 0, 4, 0, 0, 6, 0, 1, 1, 6, 1, 1, 0, 0, 1],
    [1, 4, 0, 0, 4, 0, 0, 0, 1, 0, 0, 1, 1, 1, 1, 1, 1, 1, 0, 0, 1, 0, 0, 0, 4, 0, 0, 0, 4, 1],
    [1, 0, 0, 0, 0, 0, 0, 0, 1, 4, 0, 1, 8, 0, 0, 0, 10, 1, 0, 4, 1, 0, 0, 0, 0, 0, 0, 0, 0, 1],
    [1, 1, 1, 6, 1, 1, 1, 4, 1, 0, 0, 1, 0, 0, 4, 0, 0, 1, 0, 0, 1, 0, 1, 1, 1, 6, 1, 1, 1, 1],
    [1, 0, 0, 0, 0, 0, 1, 0, 1, 0, 0, 6, 0, 0, 0, 0, 0, 6, 0, 0, 1, 0, 1, 0, 4, 0, 0, 0, 0, 1],
    [1, 4, 4, 0, 4, 0, 6, 0, 1, 4, 0, 1, 0, 0, 0, 0, 0, 1, 0, 4, 1, 0, 6, 0, 4, 0, 4, 0, 4, 1],
    [1, 0, 0, 0, 0, 0, 1, 0, 1, 0, 0, 1, 0, 0, 4, 0, 0, 1, 0, 0, 1, 0, 1, 0, 0, 0, 0, 0, 0, 1],
    [1, 1, 1, 1, 1, 1, 1, 4, 1, 0, 0, 6, 0, 11, 0, 11, 0, 6, 0, 0, 1, 0, 1, 1, 1, 1, 1, 1, 1, 1],
    [1, 0, 0, 0, 4, 0, 0, 0, 1, 4, 0, 1, 0, 0, 0, 0, 0, 1, 0, 4, 1, 0, 0, 0, 4, 0, 0, 0, 4, 1],
    [1, 0, 1, 1, 6, 1, 1, 0, 1, 1, 0, 1, 1, 1, 1, 1, 1, 1, 0, 1, 1, 0, 1, 1, 6, 1, 1, 0, 0, 1],
    [1, 0, 1, 0, 0, 0, 1, 4, 0, 0, 0, 0, 0, 0, 4, 0, 0, 0, 0, 0, 0, 0, 1, 0, 0, 0, 1, 0, 4, 1],
    [1, 4, 6, 0, 4, 0, 6, 0, 0, 0, 1, 1, 1, 6, 1, 6, 1, 1, 1, 0, 0, 0, 6, 0, 4, 0, 6, 0, 0, 1],
    [1, 0, 1, 12, 0, 0, 1, 4, 4, 0, 1, 0, 0, 0, 0, 0, 0, 0, 1, 0, 4, 0, 1, 0, 0, 12, 1, 0, 0, 1],
    [1, 4, 1, 1, 6, 1, 1, 0, 0, 0, 6, 0, 11, 0, 0, 0, 11, 0, 6, 0, 0, 0, 1, 1, 6, 1, 1, 0, 0, 1],
    [1, 2, 0, 0, 0, 0, 0, 0, 0, 0, 1, 0, 0, 0, 4, 0, 0, 0, 1, 0, 0, 4, 0, 0, 0, 0, 0, 0, 3, 1],
    [1, 0, 0, 0, 0, 0, 0, 0, 0, 0, 0, 0, 0, 0, 0, 0, 0, 0, 0, 0, 0, 0, 0, 0, 0, 4, 0, 0, 0, 1],
    [1, 1, 1, 1, 1, 1, 1, 1, 1, 1, 1, 1, 1, 1, 1, 1, 1, 1, 1, 1, 1, 1, 1, 1, 1, 1, 1, 1, 1, 1]
]