[
    [1, 1, 1, 1, 1, 1, 1, 1, 1, 1, 1, 1, 1, 1, 1, 1, 1, 1, 1, 1, 1, 1, 1, 1, 1, 1, 1, 1, 1, 1],
    [1, 5, 0, 0, 0, 12, 0, 0, 0, 0, 0, 0, 0, 0, 0, 0, 0, 0, 0, 0, 0, 0, 0, 0, 0, 0, 0, 2, 3, 1],
    [1, 0, 0, 11, 0, 0, 0, 0,11,12, 0, 0, 0, 0, 0, 0, 0, 0, 0, 0, 0, 0, 0, 0, 0, 0, 0, 0, 0, 1],
    [1, 0, 11, 1, 1, 1, 1, 1, 0, 0, 1, 1, 1, 1, 1, 1, 1, 1, 1, 0, 0, 1, 1, 1, 1, 1, 0, 0, 0, 1],
    [1,11,12, 1, 0, 0, 0, 1, 4, 0, 1, 0, 0, 0, 0, 0, 4, 0, 1, 0, 0, 1, 0, 0, 0, 1, 0, 0, 0, 1],
    [1, 0, 0, 1, 0, 4, 0, 6, 0,12, 1, 0, 0, 0,11, 0, 0, 0, 6, 0, 0, 1, 0, 4, 0, 1, 0, 0, 0, 1],
    [1, 0, 0, 1,11,12, 0, 6, 0,11, 6, 0, 0, 0, 0, 0, 0, 0, 6, 0, 0, 6, 0, 0, 0, 1, 0, 0, 0, 1],
    [1, 0, 0, 1, 0, 0, 0, 1, 0, 0, 1, 0, 0, 0, 0, 0, 0, 0, 1, 0, 0, 1, 0, 0, 0, 1, 0, 0, 0, 1],
    [1, 0, 0, 1, 1, 6, 1, 1, 4, 0, 1, 1, 1, 1, 6, 6, 1, 1, 1, 0, 0, 1, 1, 6, 1, 1, 0, 0, 0, 1],
    [1,12,11, 0, 0, 0, 0, 0, 0, 0, 0, 0, 0, 0, 0, 0, 0, 0, 0, 0, 0, 0, 0, 0, 0, 0, 0, 0, 0, 1],
    [1, 0, 0, 0, 0, 0, 0, 0, 0, 0, 0, 0, 0, 0, 0, 0, 0, 0, 0, 0, 0, 0, 0, 0, 0, 0, 0, 0, 0, 1],
    [1, 1, 1, 1, 1, 0, 0, 1, 1, 1, 1, 1, 1, 1, 0, 4, 1, 1, 1, 1, 1, 1, 0, 0, 1, 1, 1, 1, 1, 1],
    [1, 0, 0, 0, 1, 0, 0, 1, 0, 0, 0, 0, 0, 0, 0, 0, 0, 0, 0, 0, 0, 1, 0, 0, 1, 0, 0, 0, 0, 1],
    [1, 0, 7, 0, 1, 0, 0, 6, 0,12, 0, 0, 0, 0, 0, 0, 0, 0, 0, 0, 0, 1, 0, 0, 1, 0, 8, 0, 0, 1],
    [1, 0, 4, 0, 6, 0, 0, 6, 0,12, 0,12, 0, 0,11,11, 0,12, 0, 0, 0, 6, 0, 0, 6, 0, 0, 0, 0, 1],
    [1, 11, 9, 0, 6, 0, 0, 1, 0, 0, 4, 0, 0, 0, 12, 0, 0, 0, 0, 0, 0, 1, 0, 0, 1, 0, 10, 0, 0, 1],
    [1, 0, 0, 0, 1, 0, 0, 1, 0, 0, 0, 0, 0, 0, 0, 0, 0, 0, 0, 0, 0, 1, 0, 0, 1, 0, 0, 0, 0, 1],
    [1, 1, 1, 1, 1, 0, 0, 1, 1, 1, 1, 1, 1, 1, 0, 4, 1, 1, 1, 1, 1, 1, 0, 0, 1, 1, 1, 1, 1, 1],
    [1, 0, 0, 0, 0, 0, 0, 0, 0, 0, 0, 0, 0, 0, 0, 0, 0, 0, 0, 0, 0, 0, 0, 0, 0, 0, 0, 0, 0, 1],
    [1, 0, 0, 0, 0, 0, 0, 0, 4, 0, 0, 0, 0, 0, 0, 0, 0, 0, 0, 0, 0, 0, 0, 0, 0, 0, 0, 0, 0, 1],
    [1, 0, 0, 1, 1, 6, 1, 1, 0, 4, 1, 1, 1, 1, 6, 1, 1, 1, 1, 0, 0, 1, 1, 6, 1, 1, 0, 0, 0, 1],
    [1, 0, 0, 1, 0, 0, 0, 1, 0, 0, 1, 0, 0, 0, 0, 0, 0, 0, 1, 0, 0, 1, 0, 0, 0, 1, 0, 0, 0, 1],
    [1,11,11, 1, 0, 0, 0, 6, 4, 0, 6, 0, 4, 0, 0, 0,12, 0, 6, 0, 0, 6,12, 11, 0, 1, 0, 0, 0, 1],
    [1,11,11, 1, 0, 4, 0, 6, 0, 4, 6, 0, 0,12,11, 0, 0, 0, 6, 0, 0, 6, 0, 4, 0, 1, 0, 0, 0, 1],
    [1,12,12, 1, 0, 0, 0, 1, 0, 0, 1, 0, 0, 0, 0, 0, 0, 0, 1, 0, 0, 1, 0, 0, 0, 1, 0, 0, 0, 1],
    [1, 0, 0, 1, 1, 1, 1, 1, 0, 0, 1, 1, 1, 1, 1, 1, 1, 1, 1, 0, 0, 1, 1, 1, 1, 1, 0, 0, 0, 1],
    [1, 3, 2, 0, 0, 0, 0, 0, 0, 0, 0, 0, 0, 0, 0, 0, 0, 0, 0, 0, 0, 0, 0, 0, 0, 0, 0, 0, 0, 1],
    [1, 1, 1, 1, 1, 1, 1, 1, 1, 1, 1, 1, 1, 1, 1, 1, 1, 1, 1, 1, 1, 1, 1, 1, 1, 1, 1, 1, 1, 1]
]