[
    [1, 1, 1, 1, 1, 1, 1, 1, 1, 1, 1, 1, 1, 1, 1, 1, 1, 1, 1, 1, 1, 1, 1, 1, 1, 1, 1, 1, 1, 1],
    [1, 5, 0, 0, 0, 0, 0, 0, 0, 0, 0, 0, 0, 0, 0, 0, 0, 0, 0, 0, 0, 0, 0, 0, 0, 0, 0, 0, 3, 1],
    [1, 0, 1, 1, 6, 1, 1, 0, 1, 1, 1, 1, 1, 0, 0, 0, 1, 1, 1, 1, 1, 0, 1, 1, 6, 1, 1, 0, 0, 1],
    [1, 0, 1, 0, 0, 0, 1, 0, 1, 0, 0, 0, 1, 0,12, 0, 1, 0, 0, 0, 1, 0, 1, 0, 0, 0, 1, 0, 0, 1],
    [1, 0, 6,12,11, 0, 6, 0, 6, 0, 4, 0, 6, 0, 0, 0, 6, 0, 4, 0, 6, 0, 6, 0,11, 0, 6, 0, 0, 1],
    [1, 0, 1, 0, 0, 0, 1, 0, 6, 0, 0, 0, 6, 0, 0, 0, 1, 0, 0, 0, 1, 0, 1, 0, 0, 0, 1, 0, 0, 1],
    [1, 0, 1, 1, 6, 6, 1, 0, 1, 1, 6, 1, 1, 0, 0, 0, 1, 1, 6, 1, 1, 0, 1, 1, 6, 1, 1, 0, 0, 1],
    [1, 0, 0, 0, 0, 0, 0, 0, 0, 0, 0, 0, 0, 0,11,12,12,12,11, 0, 0, 0, 0, 0, 0, 0, 0, 0, 0, 1],
    [1, 0, 1, 1, 1, 1, 1, 0, 1, 1, 0, 1, 1, 1, 1, 1, 1, 1, 0, 1, 1, 0, 1, 1, 1, 1, 1, 0, 0, 1],
    [1, 0, 0, 0, 0, 0, 0, 0, 1, 4, 0, 0, 0, 0, 0, 0, 0, 0, 0, 4, 1, 0, 0, 0, 0, 0, 0, 0, 0, 1],
    [1, 1, 1, 1, 1, 1, 1, 0, 1, 1, 1, 1, 1,11,11,11, 1, 1, 1, 1, 1, 0, 1, 1, 1, 1, 1, 1, 0, 1],
    [1, 0, 0, 0, 0, 0, 1, 0, 0, 0, 0, 0, 0,11,12,11, 0, 0, 0, 0, 0, 0, 1, 0, 0, 0, 0, 0, 0, 1],
    [1, 0, 0, 0, 4, 0, 1, 0, 0, 0, 1, 1, 1, 1, 1, 1, 1, 1, 1, 0, 0, 0, 1, 0, 4, 0, 0, 0, 0, 1],
    [1, 0, 0, 0, 0, 0, 1, 0, 0, 0, 1, 7, 0, 0, 0, 0, 0,10, 1, 0, 0, 0, 1, 0, 0, 0, 4, 0, 0, 1],
    [1, 1, 6, 6, 1, 1, 1, 0,11, 0, 1, 0, 4,11, 0, 4, 0, 0, 1, 0,11, 0, 1, 1, 1, 1, 6, 1, 1, 1],
    [1, 0, 0, 0, 0, 0, 0, 0, 0, 0, 6, 0, 4, 4, 0,11, 0, 0, 6, 0, 0, 0, 0, 0, 0, 0, 0, 0, 0, 1],
    [1, 0, 0, 0, 0, 0, 0, 0, 0, 0, 6, 0, 0,12, 0, 0, 0, 0, 6, 0, 0, 0, 0, 0, 0, 0, 0, 0, 0, 1],
    [1, 0, 1, 1, 1, 1, 1, 1, 1, 1, 1, 0,11,12, 4, 0, 0, 0, 1, 1, 1, 1, 1, 1, 1, 1, 1, 0, 0, 1],
    [1, 0, 0, 0, 0, 0, 0, 0, 0, 0, 1, 0, 0, 0, 0, 4, 0, 0, 1, 0, 0, 0, 0, 0, 0, 0, 0, 0, 0, 1],
    [1, 0, 0, 0, 0, 0, 0, 0, 0, 0, 6, 0, 0,11,12,12, 4, 0, 6, 0, 0, 0, 0, 0, 0, 0, 4, 0, 0, 1],
    [1, 1, 6, 6, 1, 1, 1, 0,11, 0, 6, 0,12,11,11,12, 0, 0, 6, 0,11, 0, 1, 1, 1, 1, 6, 1, 1, 1],
    [1, 0, 0, 0, 0, 0, 1, 0, 0, 0, 1,10, 0, 0, 0, 0, 0,10, 1, 0, 0, 0, 1, 0, 0, 0, 0, 0, 0, 1],
    [1, 0, 0, 0, 4, 0, 1, 0, 0, 0, 1, 1, 1, 1, 1, 1, 1, 1, 1, 0, 4, 0, 1, 0, 4, 0, 0, 0, 0, 1],
    [1, 0, 0, 0, 0, 0, 1, 0, 0, 0, 0, 0, 0, 0,12, 0, 0, 0, 0, 0, 0, 0, 1, 0, 0, 0, 0, 0, 0, 1],
    [1, 1, 1, 1, 1, 1, 1, 0, 1, 1, 1, 1, 1, 0, 0, 0, 1, 1, 1, 1, 1, 0, 1, 1, 1, 1, 1, 1, 0, 1],
    [1, 0, 0, 0, 0, 0, 0, 0, 1, 4, 0, 0, 4, 0, 0, 0, 0, 0, 0, 4, 1, 0, 0, 0, 0, 0, 0, 0, 0, 1],
    [1, 0, 1, 1, 1, 1, 1, 0, 1, 1, 0, 1, 1, 1, 1, 1, 1, 1, 0, 1, 1, 0, 1, 1, 1, 1, 1, 0, 0, 1],
    [1, 0, 0, 0, 0, 0, 0, 0, 0, 0, 0, 0, 0, 0, 0, 0, 0, 0, 0, 0, 3, 0, 0, 0, 0, 0, 0, 0, 0, 1],
    [1, 0, 1, 1, 6, 6, 1, 0, 1, 1, 6, 1, 1, 0, 0, 0, 1, 1, 6, 6, 1, 0, 1, 1, 6, 1, 1, 4, 0, 1],
    [1, 0, 1, 0, 0, 0, 1, 0, 6, 0, 0, 0, 6, 0, 0, 0, 6, 0, 0, 0, 1, 0, 1, 0, 0, 0, 1, 0, 0, 1],
    [1, 0, 6, 0,11, 0, 6, 0, 6, 0, 4, 0, 6, 0, 0, 0, 6, 0, 4, 0, 6, 0, 6, 0,11, 0, 6, 0, 0, 1],
    [1, 0, 1, 0, 0, 0, 1, 0, 1, 0, 0, 0, 1, 0,12, 0, 1, 0, 0, 0, 6, 0, 1, 0, 0, 0, 1, 0, 0, 1],
    [1, 0, 1, 1, 6, 6, 1, 0, 1, 1, 1, 1, 1, 0, 0, 0, 1, 1, 1, 1, 1, 0, 1, 1, 6, 1, 1, 0, 0, 1],
    [1, 0, 0, 0, 0, 0, 0, 0, 0, 0, 0,11, 0,11, 0, 0, 0,12, 0, 0, 0, 0, 0, 0, 0, 0, 0, 0, 2, 1],
    [1,10, 0, 0, 0, 0,11,12,12,11, 0, 0, 0,12,11, 0, 0, 0, 0, 0, 0, 0, 0, 0, 0, 0, 4, 0, 0, 1],
    [1, 1, 1, 1, 1, 1, 1, 1, 1, 1, 1, 1, 1, 1, 1, 1, 1, 1, 1, 1, 1, 1, 1, 1, 1, 1, 1, 1, 1, 1]
]